###########
#.........#
#.........#
#.........#
#.........#
#........@#
###########