###########
#................#
#.........#
#....@....#
#.........#
#.............#
###########